############################
#------------##------------#
#-####-#####-##-#####-####-#
#-####-#####-##-#####-####-#
#-####-#####-##-#####-####-#
#--------------------------#
#-####-##-########-##-####-#
#-####-##-########-##-####-#
#------##----##----##------#
######-#####-##-#####-######
-----#-#####-##-#####-#-----
-----#-##----------##-#-----
-----#-##-###--###-##-#-----
######-##-#------#-##-######
----------#------#----------
######-##-#------#-##-######
-----#-##-########-##-#-----
-----#-##----------##-#-----
-----#-##-########-##-#-----
######-##-########-##-######
#------------##------------#
#-####-#####-##-#####-####-#
#-####-#####-##-#####-####-#
#---##----------------##---#
###-##-##-########-##-##-###
###-##-##-########-##-##-###
#------##----##----##------#
#-##########-##-##########-#
#-##########-##-##########-#
#--------------------------#
############################




#########-##########
#----#--------#----#
#-##-#-######-#-##-#
#-#--------------#-#
#-#-##-##--##-##-#-#
-------#----#-------
#-#-##-######-##-#-#
#-#--------------#-#
#-##-#-######-#-##-#
#----#--------#----#
##########-#########
